41 20
.........................................
.........................................
...******......*......*.....*..******....
...**........**.**....**.*.**..**........
...**.***....*****....**...**..*****.....
...**..**...**...**...**...**..**........
...******..**.....**..**...**..******....
.........................................
.........................................
.........................................
...******..**.....**..******..******.....
...******...**...**...**......**...**....
...**..**....**.**....**......**...**....
...**..**....**.**....*****...*****......
...******.....***.....**......**..**.....
...******......*......******..**...**....
.........................................
.........................................
.........................................

