41 20
#########################################
#.......................................#
#...******......*......*.....*..******..#
#...**........**.**....***.***..**......#
#...**.***....*****....**.*.**..*****...#
#...**..**...**...**...**...**..**......#
#...******..**.....**..**...**..******..#
#.......................................#
#.......................................#
#...******..**.....**..******..******...#
#...******...**...**...**......**...**..#
#...**..**....**.**....**......**...**..#
#...**..**....**.**....*****...*****....#
#...******.....***.....**......**..**...#
#...******......*......******..**...**..#
#.......................................#
#.......................................#
#.......................................#
#.......................................#
#########################################