41 20
.........................................
.........................................
.........................................
....**....**..********..**....**.....@...
.....**..**...********..**....**.........
.......**.....**....**..**....**.........
.......**.....**....**..**....**.........
.......**.....********..********.........
.......**.....********..********.........
.........................................
....**...........**..**..**........**....
.....**.........**...**..****......**....
......**.......**....**..**..**....**....
.......**..*..**...,.**..**....**..**....
.......****.****.....**..**......****....
........**...***.....**..**........**....
.........................................
.........................................
.........................................
