41 20
#########################################
#.......................................#
#.......................................#
#...**....**..********..**....**........#
#....**..**...********..**....**........#
#......**.....**....**..**....**........#
#......**.....**....**..**....**........#
#......**.....********..********........#
#......**.....********..********........#
#.......................................#
#...**...........**..**..**......**.....#
#....**.........**...**..****....**.....#
#.....**.......**....**..**.**...**.....#
#......**..*..**.....**..**...**.**.....#
#......****.****.....**..**....****.....#
#.......**...**......**..**......**.....#
#.......................................#
#.......................................#
#.......................................#
#########################################